111111111111111111111111111
110000111000C00000001100001
110P00000000111110011000011
111000111000011111000011111
1100011111000111110001100E1
110001111100010001000111111
110C000000000000C0001111111
111111111111111111111111111