111111111111111111111111111
110000111000C00000001100001
110P00000000111110011000011
11100011100001CC01000000111
110001111100011111000110001
110001111100010001000110E01
110C000000000000C0001110001
111111111111111111111111111