11111111111111111111111111111111111111111111111111111111
11111110011110000000000000000000000000011111100001111111
1110000000110000001110000111111110000001000000000C100001
110000P0001000000011100001111111100000010000000001000001
11000000000000000011100001111111100000010001111111100001
11111111100000000000000000000000000000010000000000000001
10000000100000010101010000000000000000000000000000000001
10000000100000011111110000000000001111111111111000000001
10000C001000000000000000000000000011000C0000000000000001
10000000100000000000110000000000001100000111111000000001
10000111100000000000110000000000001000000000000000000001
10000000000000000000110000000000001111111111111000000001
10000000000000000000110000000000000000000000000000000001
11111111111111111000000000000000000000000000000000000001
10000001000E01100000000000011111111001111111111000000001
10000100010001100000000000000011111000000011111110000001
1000011111111110000000000001111001111110000C001100000001
10000000000000000000000000000000000000000000001100000001
11111111111111111111111111111111111111111111111111111111