11111111111
11111111111
11CE0000011
11000P00011
11000000011
11111111111
11111111111